// MilkShape 3D ASCII

Block: 0
Frames: 30
Frame: 1

Meshes: 2
"Roof" 1 1
25
1 0.000000 6.000000 0.000000 0.500000 0.500000 -1
1 0.750000 6.000000 0.000000 0.250000 0.500000 -1
1 0.750000 6.000000 0.750000 0.250000 0.250000 -1
1 0.000000 6.000000 1.500000 0.500000 0.000000 -1
1 0.000000 6.000000 0.750000 0.500000 0.250000 -1
1 0.750000 6.000000 1.500000 0.250000 0.000000 -1
1 0.000000 6.000000 -1.500000 0.500000 1.000000 -1
1 0.000000 6.000000 -0.750000 0.500000 0.750000 -1
1 -0.750000 6.000000 -1.500000 0.750000 1.000000 -1
1 1.500000 6.000000 0.000000 0.000000 0.500000 -1
1 0.750000 6.000000 -0.750000 0.250000 0.750000 -1
1 1.500000 6.000000 -0.750000 0.000000 0.750000 -1
1 -1.500000 6.000000 0.000000 1.000000 0.500000 -1
1 -0.750000 6.000000 0.750000 0.750000 0.250000 -1
1 -1.500000 6.000000 0.750000 1.000000 0.250000 -1
1 -0.750000 6.000000 0.000000 0.750000 0.500000 -1
1 -0.750000 6.000000 -0.750000 0.750000 0.750000 -1
1 1.500000 6.000000 1.500000 0.000000 0.000000 -1
1 1.500000 6.000000 0.750000 0.000000 0.250000 -1
1 -1.500000 6.000000 -1.500000 1.000000 1.000000 -1
1 1.500000 6.000000 -1.500000 0.000000 1.000000 -1
1 0.750000 6.000000 -1.500000 0.250000 1.000000 -1
1 -1.500000 6.000000 1.500000 1.000000 0.000000 -1
1 -0.750000 6.000000 1.500000 0.750000 0.000000 -1
1 -1.500000 6.000000 -0.750000 1.000000 0.750000 -1
1
0.000000 -1.000000 0.000000
32
1 0 1 2 0 0 0 1
1 3 4 5 0 0 0 1
1 6 7 8 0 0 0 1
1 9 10 11 0 0 0 1
1 0 7 1 0 0 0 1
1 12 13 14 0 0 0 1
1 0 15 16 0 0 0 1
1 3 13 4 0 0 0 1
1 17 2 18 0 0 0 1
1 9 18 1 0 0 0 1
1 1 18 2 0 0 0 1
1 17 5 2 0 0 0 1
1 0 2 4 0 0 0 1
1 4 2 5 0 0 0 1
1 19 8 16 0 0 0 1
1 0 16 7 0 0 0 1
1 7 16 8 0 0 0 1
1 20 11 21 0 0 0 1
1 6 21 10 0 0 0 1
1 10 21 11 0 0 0 1
1 9 1 10 0 0 0 1
1 6 10 7 0 0 0 1
1 7 10 1 0 0 0 1
1 22 14 23 0 0 0 1
1 3 23 13 0 0 0 1
1 13 23 14 0 0 0 1
1 19 16 24 0 0 0 1
1 12 24 15 0 0 0 1
1 15 24 16 0 0 0 1
1 0 4 15 0 0 0 1
1 12 15 13 0 0 0 1
1 13 15 4 0 0 0 1
"Floor" 1 0
25
1 1.500000 0.000000 1.500000 0.000000 0.000000 -1
1 1.500000 0.000000 0.750000 0.000000 0.250000 -1
1 0.750000 0.000000 0.750000 0.250000 0.250000 -1
1 0.750000 0.000000 1.500000 0.250000 0.000000 -1
1 -1.500000 0.000000 -1.500000 1.000000 1.000000 -1
1 -0.750000 0.000000 -0.750000 0.750000 0.750000 -1
1 -0.750000 0.000000 -1.500000 0.750000 1.000000 -1
1 1.500000 0.000000 -1.500000 0.000000 1.000000 -1
1 0.750000 0.000000 -1.500000 0.250000 1.000000 -1
1 1.500000 0.000000 -0.750000 0.000000 0.750000 -1
1 1.500000 0.000000 0.000000 0.000000 0.500000 -1
1 0.750000 0.000000 -0.750000 0.250000 0.750000 -1
1 0.750000 0.000000 0.000000 0.250000 0.500000 -1
1 -1.500000 0.000000 1.500000 1.000000 0.000000 -1
1 -0.750000 0.000000 1.500000 0.750000 0.000000 -1
1 -1.500000 0.000000 0.750000 1.000000 0.250000 -1
1 -1.500000 0.000000 -0.750000 1.000000 0.750000 -1
1 0.000000 0.000000 0.000000 0.500000 0.500000 -1
1 -0.750000 0.000000 0.000000 0.750000 0.500000 -1
1 0.000000 0.000000 0.750000 0.500000 0.250000 -1
1 0.000000 0.000000 1.500000 0.500000 0.000000 -1
1 0.000000 0.000000 -1.500000 0.500000 1.000000 -1
1 0.000000 0.000000 -0.750000 0.500000 0.750000 -1
1 -1.500000 0.000000 0.000000 1.000000 0.500000 -1
1 -0.750000 0.000000 0.750000 0.750000 0.250000 -1
1
0.000000 1.000000 0.000000
32
1 0 1 2 0 0 0 1
1 0 2 3 0 0 0 1
1 4 5 6 0 0 0 1
1 7 8 9 0 0 0 1
1 10 11 12 0 0 0 1
1 13 14 15 0 0 0 1
1 4 16 5 0 0 0 1
1 17 18 19 0 0 0 1
1 17 2 12 0 0 0 1
1 10 12 1 0 0 0 1
1 1 12 2 0 0 0 1
1 20 3 19 0 0 0 1
1 17 19 2 0 0 0 1
1 2 19 3 0 0 0 1
1 21 6 22 0 0 0 1
1 17 22 5 0 0 0 1
1 5 22 6 0 0 0 1
1 10 9 11 0 0 0 1
1 21 11 8 0 0 0 1
1 8 11 9 0 0 0 1
1 17 12 22 0 0 0 1
1 21 22 11 0 0 0 1
1 11 22 12 0 0 0 1
1 23 15 24 0 0 0 1
1 20 24 14 0 0 0 1
1 14 24 15 0 0 0 1
1 17 5 18 0 0 0 1
1 23 18 16 0 0 0 1
1 16 18 5 0 0 0 1
1 20 19 24 0 0 0 1
1 23 24 18 0 0 0 1
1 18 24 19 0 0 0 1

Materials: 2
"FloorMaterial"
0.200000 0.200000 0.200000 1.000000
0.800000 0.800000 0.800000 1.000000
0.100000 0.100000 0.500000 1.000000
0.000000 0.000000 0.000000 1.000000
64.000000
1.000000
"floor.bmp"
""
"RoofMaterial"
0.300000 0.300000 0.300000 1.000000
0.800000 0.800000 0.800000 1.000000
0.000000 0.000000 0.000000 1.000000
0.000000 0.000000 0.000000 1.000000
0.000000
1.000000
"roof.bmp"
""

Bones: 0
GroupComments: 0
MaterialComments: 0
BoneComments: 0
ModelComment: 0
